样例输入：
##########
#S #   # #
#  #   # #
#    ##  #
# ###    #
#   #    #
# #   #  #
# ### ## #
##      E#
##########

样例输出：
##########
#**#!!!# #
# *#!!!# #
#**!!##  #
#*###    #
#***#    #
# #***#  #
# ###*## #
##   ****#
##########
